WWWWWWWWWWWW
W..........W
WWWWWWWWW..W
W..........W
W..WWWWWWWWW
W..........W
W..........W
WWWWWWWWWWWW